1111111111111111
10C000001C0000C1
1001110110000111
1C00110C0P00E0C1
1111111111111111