1111111111111111111111111111111111
1C0000100000000C00000C000000000001
11100111001000001010010000000101C1
1010111111101010001001000000010111
10P010000E10C0000000000000000000C1
1111111111111111111111111111111111
