11111111111111111111111111111111111
1C0000000000000C00000C0000000000001
11100101001000001010010000000100001
10100111111010100010010000000100001
10P000000E10C0000000000000000000001
11111111111111111111111111111111111
